Map_Arena.png 6 9 96 144

75 60 16 16

arena_lvl_music.ogg


4  5  6  4  5  6  4  5  6  4  5  6  4  5  6  4  
5  6  5  6  5  6  5  6  4  5  6  4  5  6  4  5  
6  4  5  6  4  5  6  4  5  6  4  5  6  4  5  6  
4  5  6  4  5  6  4  5  6  4  5  6  4  5  6  4  
5  6  4  5  6  4  5  6  4  5  6 
10  11  12  10  11  12  10  11  12  10  11  12  10  11  12  10  
11  12  11  12  11  12  11  12  10  11  12  10  11  12  10  11  
12  10  11  12  10  11  12  10  11  12  10  11  12  10  11  12  
10  11  12  10  11  12  10  11  12  10  11  12  10  11  12  10  
11  12  10  11  12  10  11  12  10  11  12 
16  17  18  16  17  18  16  17  18  16  17  18  16  17  18  16  
17  18  17  18  17  18  17  18  16  17  18  16  17  18  16  17  
18  16  17  18  16  17  18  16  17  18  16  17  18  16  17  18  
16  17  18  16  17  18  16  17  18  16  17  18  16  17  18  16  
17  18  16  17  18  16  17  18  16  17  18 
4  5  6  4  5  6  4  5  6  4  5  6  4  5  6  4  
5  6  4  5  6  1  2  3  1  2  3  1  2  3  1  2  
3  1  2  3  1  2  3  1  2  3  1  2  3  1  2  3  
1  2  3  4  5  6  4  5  6  4  5  6  4  5  6  4  
5  6  4  5  6  4  5  6  4  5  6 
10  11  12  10  11  12  10  11  12  10  11  12  10  11  12  10  
11  12  10  11  12  7  8  9  7  8  9  7  8  9  7  8  
9  7  8  9  7  8  9  7  8  9  7  8  9  7  8  9  
7  8  9  10  11  12  10  11  12  10  11  12  10  11  12  10  
11  12  10  11  12  10  11  12  10  11  12 
16  17  18  16  17  18  16  17  18  16  17  18  16  17  18  16  
17  18  16  17  18  13  14  15  13  14  15  13  14  15  13  14  
15  13  14  15  13  14  15  13  14  15  13  14  15  13  14  15  
13  14  15  16  17  18  16  17  18  16  17  18  16  17  18  16  
17  18  16  17  18  16  17  18  16  17  18 
4  5  6  4  5  6  4  5  6  4  5  6  4  5  6  1  
2  3  1  2  3  22  23  24  19  20  21  22  23  24  19  20  
21  22  23  24  19  20  21  22  23  24  19  20  21  22  23  24  
19  20  21  1  2  3  1  2  3  4  10  11  4  5  6  4  
5  6  4  5  6  4  5  6  4  5  6 
10  11  12  10  11  12  10  11  12  10  11  12  10  11  12  7  
8  9  7  8  9  28  29  30  25  26  27  28  29  30  25  26  
27  28  29  30  25  26  27  28  29  30  25  26  27  28  29  30  
25  26  27  7  8  9  7  8  9  10  16  17  10  11  12  10  
11  12  10  11  12  10  11  12  10  11  12 
16  17  18  16  17  18  16  17  18  16  17  18  16  17  18  13  
14  15  13  14  15  34  35  36  31  32  33  34  35  36  31  32  
33  34  35  36  31  32  33  34  35  36  31  32  33  34  35  36  
31  32  33  13  14  15  13  14  15  16  17  18  16  17  18  16  
17  18  16  17  18  16  17  18  16  17  18 
4  5  6  4  5  6  4  5  6  4  5  6  1  2  3  40  
41  42  37  38  39  40  41  42  37  38  39  40  41  42  37  38  
39  40  41  42  37  38  39  40  41  42  37  38  39  40  41  42  
37  38  39  40  41  42  37  38  39  1  2  3  4  5  6  4  
5  6  4  5  6  4  5  6  4  5  6 
10  11  12  10  11  12  10  11  12  10  11  12  7  8  9  46  
47  48  43  44  45  46  47  48  43  44  45  46  47  48  43  44  
45  46  47  48  43  44  45  46  47  48  43  44  45  46  47  48  
43  44  45  46  47  48  43  44  45  7  8  9  10  11  12  10  
11  12  10  11  12  10  11  12  10  11  12 
16  17  18  16  17  18  16  17  18  16  17  18  13  14  15  52  
53  54  49  50  51  52  53  54  49  50  51  52  53  54  49  50  
51  52  53  54  49  50  51  52  53  54  49  50  51  52  53  54  
49  50  51  52  53  54  49  50  51  13  14  15  16  17  18  16  
17  18  16  17  18  16  17  18  16  17  18 
4  5  6  4  5  6  4  5  6  1  2  3  19  20  21  22  
23  24  19  20  21  22  23  24  19  20  21  22  23  24  19  20  
21  22  23  24  19  20  21  22  23  24  19  20  21  22  23  24  
19  20  21  22  23  24  19  20  21  22  23  24  1  2  3  4  
5  6  4  5  6  4  5  6  4  5  6 
10  11  12  10  11  12  10  11  12  7  8  9  25  26  27  28  
29  30  25  26  27  28  29  30  25  26  27  28  29  30  25  26  
27  28  29  30  25  26  27  28  29  30  25  26  27  28  29  30  
25  26  27  28  29  30  25  26  27  28  29  30  7  8  9  10  
11  12  10  11  12  10  11  12  10  11  12 
16  17  18  16  17  18  16  17  18  13  14  15  31  32  33  34  
35  36  31  32  33  34  35  36  31  32  33  34  35  36  31  32  
33  34  35  36  31  32  33  34  35  36  31  32  33  34  35  36  
31  32  33  34  35  36  31  32  33  34  35  36  13  14  15  16  
17  18  16  17  18  16  17  18  16  17  18 
4  5  6  4  5  6  1  2  3  40  41  42  37  38  39  40  
41  42  37  38  39  40  41  42  37  38  39  40  41  42  37  38  
39  40  41  42  37  38  39  40  41  42  37  38  39  40  41  42  
37  38  39  40  41  42  37  38  39  40  41  42  37  38  39  1  
2  3  4  5  6  4  5  6  4  5  6 
10  11  12  10  11  12  7  8  9  46  47  48  43  44  45  46  
47  48  43  44  45  46  47  48  43  44  45  46  47  48  43  44  
45  46  47  48  43  44  45  46  47  48  43  44  45  46  47  48  
43  44  45  46  47  48  43  44  45  46  47  48  43  44  45  7  
8  9  10  11  12  10  11  12  10  11  12 
16  17  18  16  17  18  13  14  15  52  53  54  49  50  51  52  
53  54  49  50  51  52  53  54  49  50  51  52  53  54  49  50  
51  52  53  54  49  50  51  52  53  54  49  50  51  52  53  54  
49  50  51  52  53  54  49  50  51  52  53  54  49  50  51  13  
14  15  16  17  18  16  17  18  16  17  18 
4  5  6  1  2  3  19  20  21  22  23  24  19  20  21  22  
23  24  19  20  21  22  23  24  19  20  21  22  23  24  19  20  
21  22  23  24  19  20  21  22  23  24  19  20  21  22  23  24  
19  20  21  22  23  24  19  20  21  22  23  24  19  20  21  22  
23  24  1  2  3  4  5  6  4  5  6 
10  11  12  7  8  9  25  26  27  28  29  30  25  26  27  28  
29  30  25  26  27  28  29  30  25  26  27  28  29  30  25  26  
27  28  29  30  25  26  27  28  29  30  25  26  27  28  29  30  
25  26  27  28  29  30  25  26  27  28  29  30  25  26  27  28  
29  30  7  8  9  10  11  12  10  11  12 
16  17  18  13  14  15  31  32  33  34  35  36  31  32  33  34  
35  36  31  32  33  34  35  36  31  32  33  34  35  36  31  32  
33  34  35  36  31  32  33  34  35  36  31  32  33  34  35  36  
31  32  33  34  35  36  31  32  33  34  35  36  31  32  33  34  
35  36  13  14  15  16  17  18  16  17  18 
4  5  6  40  41  42  37  38  39  40  41  42  37  38  39  40  
41  42  37  38  39  40  41  42  37  38  39  40  41  42  37  38  
39  40  41  42  37  38  39  40  41  42  37  38  39  40  41  42  
37  38  39  40  41  42  37  38  39  40  41  42  37  38  39  40  
41  42  37  38  39  1  2  3  4  5  6 
10  11  12  46  47  48  43  44  45  46  47  48  43  44  45  46  
47  48  43  44  45  46  47  48  43  44  45  46  47  48  43  44  
45  46  47  48  43  44  45  46  47  48  43  44  45  46  47  48  
43  44  45  46  47  48  43  44  45  46  47  48  43  44  45  46  
47  48  43  44  45  7  8  9  10  11  12 
16  17  18  52  53  54  49  50  51  52  53  54  49  50  51  52  
53  54  49  50  51  52  53  54  49  50  51  52  53  54  49  50  
51  52  53  54  49  50  51  52  53  54  49  50  51  52  53  54  
49  50  51  52  53  54  49  50  51  52  53  54  49  50  51  52  
53  54  49  50  51  13  14  15  16  17  18 
4  5  6  22  23  24  19  20  21  22  23  19  19  20  21  22  
23  24  19  20  21  22  23  24  19  20  21  22  23  24  19  20  
21  22  23  24  19  20  21  22  23  24  19  20  21  22  23  24  
19  20  21  22  23  24  19  20  21  22  23  24  19  20  21  22  
23  24  19  20  21  22  23  24  4  5  6 
10  11  12  28  29  30  25  26  27  28  29  25  25  26  27  28  
29  30  25  26  27  28  29  30  25  26  27  28  29  30  25  26  
27  28  29  30  25  26  27  28  29  30  25  26  27  28  29  30  
25  26  27  28  29  30  25  26  27  28  29  30  25  26  27  28  
29  30  25  26  27  28  29  30  10  11  12 
16  17  18  34  35  36  31  32  33  34  35  31  31  32  33  34  
35  36  31  32  33  34  35  36  31  32  33  34  35  36  31  32  
33  34  35  36  31  32  33  34  35  36  31  32  33  34  35  36  
31  32  33  34  35  36  31  32  33  34  35  36  31  32  33  34  
35  36  31  32  33  34  35  36  16  17  18 
4  5  6  40  41  42  37  38  39  40  41  37  37  38  39  40  
41  42  37  38  39  40  41  42  37  38  39  40  41  42  37  38  
39  40  41  42  37  38  39  40  41  42  37  38  39  40  41  42  
37  38  39  40  41  42  37  38  39  40  41  42  37  38  39  40  
41  42  37  38  39  40  41  42  4  5  6 
10  11  12  46  47  48  43  44  45  46  47  43  43  44  45  46  
47  48  43  44  45  46  47  48  43  44  45  46  47  48  43  44  
45  46  47  48  43  44  45  46  47  48  43  44  45  46  47  48  
43  44  45  46  47  48  43  44  45  46  47  48  43  44  45  46  
47  48  43  44  45  46  47  48  10  11  12 
16  17  18  52  53  54  49  50  51  52  53  49  49  50  51  52  
53  54  49  50  51  52  53  54  49  50  51  52  53  54  49  50  
51  52  53  54  49  50  51  52  53  54  49  50  51  52  53  54  
49  50  51  52  53  54  49  50  51  52  53  54  49  50  51  52  
53  54  49  50  51  52  53  54  16  17  18 
4  5  6  22  23  24  19  20  21  22  23  24  19  20  21  22  
23  24  19  20  21  22  23  24  19  20  21  22  23  24  19  20  
21  22  23  24  19  20  21  22  23  24  19  20  21  22  23  24  
19  20  21  22  23  24  19  20  21  22  23  24  19  20  21  22  
23  24  19  20  21  22  23  24  4  5  6 
10  11  12  28  29  30  25  26  27  28  29  30  25  26  27  28  
29  30  25  26  27  28  29  30  25  26  27  28  29  30  25  26  
27  28  29  30  25  26  27  28  29  30  25  26  27  28  29  30  
25  26  27  28  29  30  25  26  27  28  29  30  25  26  27  28  
29  30  25  26  27  28  29  30  10  11  12 
16  17  18  34  35  36  31  32  33  34  35  36  31  32  33  34  
35  36  31  32  33  34  35  36  31  32  33  34  35  36  31  32  
33  34  35  36  31  32  33  34  35  36  31  32  33  34  35  36  
31  32  33  34  35  36  31  32  33  34  35  36  31  32  33  34  
35  36  31  32  33  34  35  36  16  17  18 
4  5  6  40  41  42  37  38  39  40  41  42  37  38  39  40  
41  42  37  38  39  40  41  42  37  38  39  40  41  42  37  38  
39  40  41  42  37  38  39  40  41  42  37  38  39  40  41  42  
37  38  39  40  41  42  37  38  39  40  41  42  37  38  39  40  
41  42  37  38  39  40  41  42  4  5  6 
10  11  12  46  47  48  43  44  45  46  47  48  43  44  45  46  
47  48  43  44  45  46  47  48  43  44  45  46  47  48  43  44  
45  46  47  48  43  44  45  46  47  48  43  44  45  46  47  48  
43  44  45  46  47  48  43  44  45  46  47  48  43  44  45  46  
47  48  43  44  45  46  47  48  10  11  12 
16  17  18  52  53  54  49  50  51  52  53  54  49  50  51  52  
53  54  49  50  51  52  53  54  49  50  51  52  53  54  49  50  
51  52  53  54  49  50  51  52  53  54  49  50  51  52  53  54  
49  50  51  52  53  54  49  50  51  52  53  54  49  50  51  52  
53  54  49  50  51  52  53  54  16  17  18 
4  5  6  22  23  24  19  20  21  22  23  24  19  20  21  22  
23  24  19  20  21  22  23  24  19  20  21  22  23  24  19  20  
21  22  23  24  19  20  21  22  23  24  19  20  21  22  23  24  
19  20  21  22  23  24  19  20  21  22  23  24  19  20  21  22  
23  24  19  20  21  22  23  24  4  5  6 
10  11  12  28  29  30  25  26  27  28  29  30  25  26  27  28  
29  30  25  26  27  28  29  30  25  26  27  28  29  30  25  26  
27  28  29  30  25  26  27  28  29  30  25  26  27  28  29  30  
25  26  27  28  29  30  25  26  27  28  29  30  25  26  27  28  
29  30  25  26  27  28  29  30  10  11  12 
16  17  18  34  35  36  31  32  33  34  35  36  31  32  33  34  
35  36  31  32  33  34  35  36  31  32  33  34  35  36  31  32  
33  34  35  36  31  32  33  34  35  36  31  32  33  34  35  36  
31  32  33  34  35  36  31  32  33  34  35  36  31  32  33  34  
35  36  31  32  33  34  35  36  16  17  18 
4  5  6  40  41  42  37  38  39  40  41  42  37  38  39  40  
41  42  37  38  39  40  41  42  37  38  39  40  41  42  37  38  
39  40  41  42  37  38  39  40  41  42  37  38  39  40  41  42  
37  38  39  40  41  42  37  38  39  40  41  42  37  38  39  40  
41  42  37  38  39  4  5  6  4  5  6 
10  11  12  46  47  48  43  44  45  46  47  48  43  44  45  46  
47  48  43  44  45  46  47  48  43  44  45  46  47  48  43  44  
45  46  47  48  43  44  45  46  47  48  43  44  45  46  47  48  
43  44  45  46  47  48  43  44  45  46  47  48  43  44  45  46  
47  48  43  44  45  10  11  12  10  11  12 
16  17  18  52  53  54  49  50  51  52  53  54  49  50  51  52  
53  54  49  50  51  52  53  54  49  50  51  52  53  54  49  50  
51  52  53  54  49  50  51  52  53  54  49  50  51  52  53  54  
49  50  51  52  53  54  49  50  51  52  53  54  49  50  51  52  
53  54  49  50  51  16  17  18  16  17  18 
4  5  6  4  5  6  19  20  21  22  23  24  19  20  21  22  
23  24  19  20  21  22  23  24  19  20  21  22  23  24  19  20  
21  22  23  24  19  20  21  22  23  24  19  20  21  22  23  24  
19  20  21  22  23  24  19  20  21  22  23  24  19  20  21  22  
23  24  4  5  6  4  5  6  4  5  6 
10  11  12  10  11  12  25  26  27  28  29  30  25  26  27  28  
29  30  25  26  27  28  29  30  25  26  27  28  29  30  25  26  
27  28  29  30  25  26  27  28  29  30  25  26  27  28  29  30  
25  26  27  28  29  30  25  26  27  28  29  30  25  26  27  28  
29  30  10  11  12  10  11  12  10  11  12 
16  17  18  16  17  18  31  32  33  34  35  36  31  32  33  34  
35  36  31  32  33  34  35  36  31  32  33  34  35  36  31  32  
33  34  35  36  31  32  33  34  35  36  31  32  33  34  35  36  
31  32  33  34  35  36  31  32  33  34  35  36  31  32  33  34  
35  36  16  17  18  16  17  18  16  17  18 
4  5  6  4  5  6  4  5  6  40  41  42  37  38  39  40  
41  42  37  38  39  40  41  42  37  38  39  40  41  42  37  38  
39  40  41  42  37  38  39  40  41  42  37  38  39  40  41  42  
37  38  39  40  41  42  37  38  39  40  41  42  37  38  39  4  
5  6  4  5  6  4  5  6  4  5  6 
10  11  12  10  11  12  10  11  12  46  47  48  43  44  45  46  
47  48  43  44  45  46  47  48  43  44  45  46  47  48  43  44  
45  46  47  48  43  44  45  46  47  48  43  44  45  46  47  48  
43  44  45  46  47  48  43  44  45  46  47  48  43  44  45  10  
11  12  10  11  12  10  11  12  10  11  12 
16  17  18  16  17  18  16  17  18  52  53  54  49  50  51  52  
53  54  49  50  51  52  53  54  49  50  51  52  53  54  49  50  
51  52  53  54  49  50  51  52  53  54  49  50  51  52  53  54  
49  50  51  52  53  54  49  50  51  52  53  54  49  50  51  16  
17  18  16  17  18  16  17  18  16  17  18 
4  5  6  4  5  6  4  5  6  4  5  6  19  20  21  22  
23  24  19  20  21  22  23  24  19  20  21  22  23  24  19  20  
21  22  23  24  19  20  21  22  23  24  19  20  21  22  23  24  
19  20  21  22  23  24  19  20  21  22  23  24  4  5  6  4  
5  6  4  5  6  4  5  6  4  5  6 
10  11  12  10  11  12  10  11  12  10  11  12  25  26  27  28  
29  30  25  26  27  28  29  30  25  26  27  28  19  20  21  22  
23  24  29  30  25  26  27  28  29  30  25  26  27  28  29  30  
25  26  27  28  29  30  25  26  27  28  29  30  10  11  12  10  
11  12  10  11  12  10  11  12  10  11  12 
16  17  18  16  17  18  16  17  18  16  17  18  31  32  33  34  
35  36  31  32  33  34  35  36  31  32  33  19  20  21  22  23  
24  24  35  36  31  32  33  34  35  36  31  32  33  34  35  36  
31  32  33  34  35  36  31  32  33  34  35  36  16  17  18  16  
17  18  4  5  6  16  17  18  16  17  18 
4  5  6  4  5  6  4  5  6  4  5  6  4  5  6  40  
41  42  37  38  39  40  41  42  37  38  39  19  20  21  22  23  
24  24  19  20  21  22  23  24  19  20  21  22  23  24  41  42  
37  38  39  40  41  42  37  38  39  4  5  6  4  5  6  4  
5  6  4  5  6  4  5  6  4  5  6 
10  11  12  10  11  12  10  11  12  10  11  12  10  11  12  46  
47  48  43  44  45  46  47  48  43  44  45  25  26  27  28  29  
30  30  25  26  27  28  29  30  25  26  27  28  29  30  47  48  
43  44  45  46  47  48  43  44  45  10  11  12  10  11  12  10  
11  12  10  11  12  10  11  12  10  11  12 
16  17  18  16  17  18  16  17  18  16  17  18  16  17  18  52  
53  54  49  50  51  52  53  54  49  50  51  31  32  33  34  35  
36  36  31  32  33  34  35  36  31  32  33  34  35  36  53  54  
49  50  51  52  53  54  49  50  51  16  17  18  16  17  18  16  
17  18  16  17  18  16  17  18  16  17  18 
4  5  6  4  5  6  4  5  6  4  5  6  4  5  6  4  
5  6  4  5  6  4  5  6  4  5  6  37  38  39  40  41  
42  42  37  38  39  40  41  42  37  38  39  40  41  4  5  6  
4  5  6  4  5  6  4  5  6  4  5  6  4  5  6  4  
5  6  4  5  6  4  5  6  4  5  6 
10  11  12  10  11  12  10  11  12  10  11  12  10  11  12  10  
11  12  10  11  12  10  11  12  10  11  12  43  44  45  46  47  
48  48  43  44  45  46  47  48  43  44  45  46  47  10  11  12  
10  11  12  10  11  12  10  11  12  10  11  12  10  11  12  10  
11  12  10  11  12  10  11  12  10  11  12 
16  17  18  16  17  18  16  17  18  16  17  18  16  17  18  16  
17  18  16  17  18  16  17  18  16  17  18  49  50  51  52  53  
54  54  49  50  51  52  53  54  49  50  51  52  53  16  17  18  
16  17  18  16  17  18  16  17  18  16  17  18  16  17  18  16  
17  18  16  17  18  16  17  18  16  17  18 
1  2  3  1  2  3  1  2  3  1  2  3  1  2  3  1  
2  3  1  2  1  2  3  1  2  1  2  1  2  3  1  2  
1  2  3  1  2  3  1  2  3  1  1  2  3  1  2  3  
1  2  3  1  2  3  1  2  3  1  2  3  1  2  3  1  
2  3  1  2  3  1  2  3  1  2  3 
7  8  9  7  8  9  7  8  9  7  8  9  7  8  9  7  
8  9  7  8  7  8  9  7  8  7  8  7  8  9  7  8  
7  8  9  7  8  9  7  8  9  7  7  8  9  7  8  9  
7  8  9  7  8  9  7  8  9  7  8  9  7  8  9  7  
8  9  7  8  9  7  8  9  7  8  9 
13  14  15  13  14  15  13  14  15  13  14  15  13  14  15  13  
14  15  13  14  13  14  15  13  14  13  14  13  14  15  13  14  
13  14  15  13  14  15  13  14  15  13  13  14  15  13  14  15  
13  14  15  13  14  15  13  14  15  13  14  15  13  14  15  13  
14  15  13  14  15  13  14  15  13  14  15

1 2 3 4 5 6 7 8 9 10 11 12 13 14 15 16 17 18