Map_Metal.png 6 12 96 192

75 60 16 16

metal_lvl_music.ogg


19  20  21  1  2  3  1  2  3  1  2  3  1  2  3  1  
2  3  1  2  3  1  2  3  1  2  3  1  2  3  1  2  
3  1  2  3  1  2  3  1  2  3  1  2  3  1  2  3  
1  2  3  1  2  3  1  2  3  1  2  3  1  2  3  1  
2  3  1  2  3  1  2  3  19  20  21 
25  26  27  7  8  9  7  8  9  7  8  9  7  8  9  7  
8  9  7  8  9  7  8  9  7  8  9  7  8  9  7  8  
9  7  8  9  7  8  9  7  8  9  7  8  9  7  8  9  
7  8  9  7  8  9  7  8  9  7  8  9  7  8  9  7  
8  9  7  8  9  7  8  9  25  26  27 
31  32  33  13  14  15  13  14  15  13  14  15  13  14  15  13  
14  15  13  14  15  13  14  15  13  14  15  13  14  15  13  14  
15  13  14  15  13  14  15  13  14  15  13  14  15  13  14  15  
13  14  15  13  14  15  13  14  15  13  14  15  13  14  15  13  
14  15  13  14  15  13  14  15  31  32  33 
19  20  21  43  44  45  46  47  48  37  37  37  37  37  37  37  
37  37  37  37  37  37  37  37  37  37  37  37  37  37  37  37  
37  37  37  37  37  37  37  37  37  37  37  37  37  37  37  37  
37  37  37  37  37  37  37  37  37  37  37  37  37  37  37  37  
37  37  37  37  38  39  40  41  19  20  21 
25  26  27  49  50  51  52  53  54  43  43  43  43  43  43  43  
43  43  43  43  43  43  43  43  43  43  43  43  43  43  43  43  
43  43  43  43  43  43  43  43  43  43  43  43  43  43  43  43  
43  43  43  43  43  43  43  43  43  43  43  43  43  43  43  43  
43  43  43  43  44  45  46  47  25  26  27 
31  32  33  55  56  57  58  59  60  49  49  49  49  49  49  49  
49  49  49  49  49  49  49  49  49  49  49  49  49  49  49  49  
49  49  49  49  49  49  49  49  49  49  49  49  49  49  49  49  
49  49  49  49  49  49  49  49  49  49  49  49  49  49  49  49  
49  49  49  49  50  51  52  53  31  32  33 
19  20  21  61  62  63  64  65  66  55  55  55  55  55  55  55  
55  55  55  55  55  55  55  55  55  55  55  55  55  55  55  55  
55  55  55  55  55  55  55  55  55  55  55  55  55  55  55  55  
55  55  55  55  55  55  55  55  55  55  55  55  55  55  55  55  
55  55  55  55  56  57  58  59  19  20  21 
25  26  27  67  68  69  70  4  4  4  61  45  45  45  45  4  
4  4  4  4  4  4  4  4  4  4  4  4  4  4  4  4  
4  4  4  4  4  4  4  4  4  4  4  4  4  4  4  4  
4  4  4  4  4  4  4  4  4  4  4  4  61  61  61  61  
61  4  4  4  62  63  64  65  25  26  27 
31  32  33  52  53  54  49  7  8  9  67  67  45  45  45  7  
8  9  7  8  9  7  8  9  7  8  9  7  8  9  7  8  
9  7  8  9  7  8  9  7  8  9  7  8  9  7  8  9  
7  8  9  7  8  9  7  8  9  7  8  9  67  67  67  67  
67  7  8  9  68  69  70  71  31  32  33 
19  20  21  58  59  60  55  13  14  15  59  60  45  45  45  13  
14  15  13  14  15  13  14  15  13  14  15  13  14  15  13  14  
15  13  14  15  13  14  15  13  14  15  13  14  15  13  14  15  
13  14  15  13  14  15  13  14  15  13  14  15  55  56  57  58  
59  13  14  15  57  58  59  60  31  32  33 
25  26  27  64  65  66  61  62  63  64  65  66  61  62  63  64  
65  66  61  62  63  64  65  66  61  62  63  64  65  66  61  62  
63  64  65  66  61  62  63  64  65  66  61  62  63  64  65  66  
61  62  63  64  65  66  61  62  63  64  65  66  61  62  63  64  
65  66  61  62  63  64  65  66  31  32  33 
31  32  33  70  71  72  67  68  69  70  71  72  67  68  69  37  
37  37  67  68  69  70  71  72  67  68  69  70  71  72  67  50  
50  50  71  72  67  68  69  50  50  50  50  50  50  50  50  72  
67  68  69  70  71  72  67  68  69  37  37  37  67  68  69  70  
71  72  67  68  69  70  71  72  31  32  33 
19  20  21  40  41  42  37  38  39  40  41  42  37  38  39  37  
37  37  37  38  39  40  41  42  37  38  39  40  41  42  37  50  
50  50  41  42  37  38  39  50  50  50  50  50  50  40  41  42  
37  38  39  40  41  42  37  38  39  37  37  37  37  38  39  40  
41  42  37  38  39  40  41  42  31  32  33 
25  26  27  46  47  48  43  44  45  46  47  48  43  44  45  37  
37  37  43  44  45  46  47  48  43  44  45  46  47  48  43  50  
50  50  50  50  50  50  50  50  50  50  50  50  50  46  47  48  
43  44  45  46  47  48  43  44  45  37  37  37  43  37  38  37  
38  39  40  41  42  46  47  48  31  32  33 
31  32  33  52  53  54  49  50  51  52  53  54  49  50  45  45  
45  45  45  50  51  52  53  54  49  50  51  52  53  54  49  4  
4  4  53  54  49  50  51  52  53  4  4  4  51  52  53  54  
49  50  51  52  53  54  49  50  51  4  4  4  49  43  44  43  
44  37  38  39  40  41  42  54  31  32  33 
19  20  21  58  59  60  55  56  57  58  59  60  55  56  45  45  
45  45  45  56  57  58  59  4  4  4  57  58  59  60  55  25  
26  27  59  60  55  56  57  58  59  25  26  27  57  58  59  60  
4  4  4  58  59  60  55  56  57  25  26  27  55  49  50  49  
50  43  44  45  46  47  48  60  31  32  33 
19  20  21  4  4  4  4  4  4  64  65  66  61  62  63  45  
45  45  61  62  63  64  65  7  8  9  63  64  65  66  61  31  
32  33  65  66  61  62  63  64  65  31  32  33  63  64  65  66  
7  8  9  64  65  66  61  62  63  31  32  33  61  55  56  55  
56  49  37  38  39  40  41  42  31  32  33 
25  26  27  7  8  9  7  8  9  70  71  72  67  68  69  45  
45  45  67  68  69  70  71  13  14  15  69  70  71  72  67  19  
20  21  71  72  67  68  69  70  71  19  20  21  37  38  39  40  
13  14  15  39  40  41  42  68  69  19  20  21  67  61  62  61  
62  55  43  44  45  46  47  48  31  32  33 
31  32  33  13  14  15  13  14  15  40  41  42  37  38  39  45  
45  45  37  38  37  38  39  40  41  37  38  39  40  41  42  25  
26  27  41  42  37  38  39  40  41  25  26  27  43  44  45  46  
47  43  44  45  46  47  48  38  39  25  26  27  37  67  68  67  
68  61  49  50  51  52  53  54  31  32  33 
19  20  21  46  47  48  43  44  45  46  47  48  43  44  45  45  
45  45  43  44  43  44  45  46  47  43  44  45  46  47  48  31  
32  33  47  48  43  44  45  46  47  31  32  33  49  50  51  52  
53  49  50  51  52  53  54  44  45  31  32  33  43  44  45  46  
47  67  55  56  57  58  59  60  31  32  33 
25  26  27  52  53  54  49  50  51  52  53  54  49  50  51  4  
4  4  49  50  49  50  51  52  53  49  50  51  52  53  54  19  
20  21  53  54  49  50  51  52  53  19  20  21  55  56  57  58  
59  55  56  57  58  59  60  50  51  19  20  21  49  50  51  52  
53  54  4  4  4  4  4  4  32  33  33 
31  32  33  58  59  60  55  56  57  58  59  60  55  56  57  25  
26  27  55  56  55  56  57  58  59  55  56  57  58  59  60  25  
26  27  39  40  41  42  57  58  59  25  26  27  61  62  63  64  
65  61  62  63  64  65  66  56  57  25  26  27  55  56  57  58  
59  60  7  8  9  7  8  9  31  32  33 
19  20  21  64  65  66  61  62  4  4  4  4  4  4  4  31  
32  33  61  62  61  62  63  64  65  61  62  63  64  65  66  31  
32  33  45  46  47  37  38  39  40  31  32  33  67  68  69  70  
71  67  68  69  70  71  72  62  63  31  32  33  61  62  63  64  
65  66  13  14  15  13  14  15  31  32  33 
19  20  21  70  71  72  67  68  7  8  9  7  7  8  9  19  
20  21  67  68  67  68  4  4  4  4  4  4  4  4  4  1  
2  3  51  52  53  43  44  45  46  1  2  3  4  4  4  4  
4  4  4  4  4  72  67  68  69  19  20  21  67  68  69  70  
71  72  67  68  69  70  71  72  31  32  33 
25  26  27  40  41  42  37  38  13  14  15  13  13  14  15  25  
26  27  37  38  39  40  7  8  9  7  8  9  7  8  9  7  
8  9  57  58  59  49  50  51  52  7  8  9  7  8  9  7  
8  9  7  8  9  42  37  38  39  25  26  27  37  38  39  40  
41  42  37  38  39  40  41  42  31  32  33 
31  32  33  46  47  48  43  44  45  46  47  48  43  44  45  31  
32  33  43  44  45  46  13  14  15  13  14  15  13  14  15  13  
14  15  63  64  65  55  56  57  58  13  14  15  13  14  15  13  
14  15  13  14  15  48  43  44  45  31  32  33  43  44  45  46  
47  48  43  44  45  46  47  48  31  32  33 
25  26  27  52  53  54  49  50  51  52  53  54  49  50  51  19  
20  21  49  50  51  52  53  54  49  67  68  69  70  71  72  50  
67  68  69  70  71  61  62  63  64  65  66  50  51  52  53  54  
49  50  51  52  53  54  49  50  51  19  20  21  49  50  51  52  
53  54  49  50  51  52  53  54  31  32  33 
19  20  21  58  59  60  55  56  57  58  59  60  55  56  57  25  
26  27  55  56  57  58  59  60  55  56  57  58  59  60  55  56  
57  58  59  37  38  39  40  41  42  71  72  56  57  58  59  60  
55  56  57  58  59  60  55  56  57  25  26  27  55  56  57  58  
59  60  55  56  57  58  59  60  31  32  33 
25  26  27  64  65  66  61  62  63  64  65  66  61  62  63  31  
32  33  61  62  63  64  65  66  61  62  63  64  65  66  61  62  
63  64  65  43  44  44  46  47  48  66  61  62  63  64  65  66  
61  62  63  64  65  66  61  62  63  31  32  33  61  62  63  64  
65  66  61  62  63  64  65  66  31  32  33 
31  32  33  4  4  4  4  4  4  70  71  72  37  4  4  21  
21  21  67  68  69  70  71  72  67  68  69  70  71  72  67  68  
69  70  71  49  50  51  52  53  54  72  67  68  69  70  71  72  
67  68  69  70  71  72  67  68  69  19  20  21  4  4  4  4  
4  4  4  4  37  70  71  72  31  32  33 
25  26  27  7  8  9  7  8  9  40  41  42  37  7  9  27  
27  27  37  37  37  37  37  37  37  37  37  37  37  37  37  37  
37  37  37  55  56  57  58  59  60  37  37  37  37  37  37  38  
39  40  41  42  37  37  37  37  37  25  26  27  7  8  9  7  
8  7  8  9  37  37  37  37  31  32  33 
31  32  33  13  14  15  13  14  15  46  47  48  37  13  15  33  
33  33  43  43  43  43  43  43  43  43  43  43  43  43  43  43  
43  43  43  61  62  63  64  65  66  43  43  43  43  43  43  44  
45  46  47  48  43  43  43  43  43  31  32  33  13  14  15  13  
14  13  14  15  37  43  43  43  31  32  33 
25  26  27  52  53  54  49  50  51  52  53  54  49  50  51  19  
20  21  49  49  49  49  4  4  4  4  4  4  4  4  4  4  
4  4  49  67  68  69  70  71  72  4  4  4  4  4  4  4  
4  4  4  4  4  37  49  49  49  19  20  21  49  49  49  49  
49  49  49  49  49  49  49  49  31  32  33 
31  32  33  58  59  60  55  56  57  58  59  60  55  56  57  25  
26  27  55  55  55  55  7  8  9  7  8  9  7  8  9  25  
26  27  55  55  55  55  55  55  55  25  26  27  7  8  9  7  
8  9  7  8  9  55  55  55  55  25  26  27  55  55  55  55  
55  55  55  55  55  55  55  55  31  32  33 
19  20  21  64  65  66  61  62  63  64  65  66  61  62  63  31  
32  33  61  61  61  61  13  14  15  13  14  15  13  14  15  31  
32  33  61  61  61  61  61  61  61  31  32  33  13  14  15  13  
14  15  13  14  15  61  61  61  61  31  32  33  61  61  61  61  
61  61  61  61  61  61  61  61  31  32  33 
25  26  27  70  71  72  67  68  69  70  71  72  67  68  69  19  
20  21  67  67  67  67  67  67  67  67  67  67  67  67  67  19  
20  21  67  67  67  67  67  67  67  19  20  21  67  67  67  68  
69  70  71  72  67  67  67  67  67  19  20  21  67  67  67  67  
67  67  67  67  67  67  67  67  31  32  33 
31  32  33  4  4  4  38  39  40  41  4  4  4  4  4  25  
26  27  37  37  38  37  37  38  37  37  38  37  38  37  37  25  
26  27  38  37  38  37  38  37  37  25  26  27  37  37  38  37  
37  38  37  37  37  37  37  37  37  25  26  27  37  37  37  37  
37  37  37  37  37  37  37  37  31  32  33 
25  26  27  7  8  9  44  45  46  47  7  8  7  8  9  31  
32  33  43  43  44  43  43  44  43  43  44  43  44  43  43  31  
32  33  44  43  44  43  44  43  43  31  32  33  43  43  44  43  
43  44  43  43  43  43  43  43  43  31  32  33  43  43  43  43  
43  43  43  43  43  43  43  43  31  32  33 
31  32  33  13  14  15  50  51  52  53  13  14  13  14  15  19  
20  21  49  49  50  49  49  50  49  49  50  49  50  49  49  19  
20  21  50  49  50  49  50  49  49  19  20  21  49  49  50  49  
68  68  68  49  49  49  49  49  49  19  20  21  49  49  49  49  
49  49  4  4  4  4  4  4  31  32  33 
25  26  27  55  55  55  56  57  58  59  60  55  55  55  55  25  
26  27  55  55  56  55  55  4  4  4  49  55  56  55  55  25  
26  27  56  55  56  55  56  55  55  25  26  27  55  55  56  55  
4  4  4  55  55  55  55  55  55  25  26  27  55  55  55  55  
55  55  7  8  7  8  9  9  31  32  33 
19  20  21  61  61  61  62  63  64  65  66  61  61  61  61  31  
32  33  61  61  62  61  61  7  8  9  49  61  62  61  61  31  
32  33  62  61  62  61  62  61  61  31  32  33  61  61  62  61  
7  8  9  61  61  61  61  61  61  31  32  33  61  61  61  61  
61  61  13  14  13  14  15  15  31  32  33 
25  26  27  67  67  67  68  69  70  71  72  67  67  67  67  1  
2  3  67  67  68  67  67  13  14  15  49  67  68  67  67  1  
2  3  68  67  68  67  68  67  67  1  2  3  67  67  68  67  
13  14  15  67  67  67  67  67  67  1  2  3  67  67  67  67  
67  67  67  67  67  67  67  67  31  32  33 
31  32  33  37  37  37  37  37  37  37  37  37  37  37  37  7  
8  9  37  37  37  37  37  37  37  37  37  37  37  37  37  7  
8  9  37  37  37  37  37  37  37  7  8  9  37  37  37  37  
37  37  37  37  37  37  37  37  37  7  8  9  37  37  37  37  
37  37  37  37  37  37  37  37  31  32  33 
31  32  33  43  43  43  43  43  43  43  43  43  43  43  43  13  
14  15  43  43  43  43  43  43  43  43  43  43  43  43  43  13  
14  15  43  43  43  43  43  43  43  13  14  15  43  43  43  43  
43  43  43  43  43  43  43  43  43  13  14  15  43  43  43  43  
43  43  43  43  43  43  43  43  31  32  33 
31  32  33  49  49  49  49  49  49  49  49  49  49  49  49  49  
49  49  49  49  49  49  49  49  49  49  49  49  49  49  49  49  
49  49  49  49  49  49  49  49  49  49  49  49  49  49  49  49  
49  49  49  49  49  49  49  49  49  49  49  49  49  49  49  49  
49  49  49  49  49  49  49  49  31  32  33 
19  20  21  55  55  55  55  55  55  55  55  55  55  55  55  55  
55  55  55  55  55  55  55  55  55  55  55  55  55  55  55  55  
55  55  55  55  55  55  55  55  55  55  55  55  55  55  55  55  
55  55  55  55  55  55  55  55  55  55  55  55  55  55  55  55  
55  55  55  55  55  55  55  55  31  32  33 
19  20  21  61  61  61  61  61  61  61  61  61  61  61  61  61  
61  61  61  61  61  61  61  61  61  61  61  61  61  61  61  61  
61  61  61  61  61  61  61  61  61  61  61  61  61  61  61  61  
61  61  61  61  61  61  61  61  61  61  61  61  61  61  61  61  
61  61  61  61  61  61  61  61  31  32  33 
25  26  27  67  67  67  67  67  67  67  67  67  67  67  67  67  
67  67  67  67  67  67  67  67  67  67  67  67  67  67  67  67  
67  67  67  67  67  67  67  67  67  67  67  67  67  67  67  67  
67  67  67  67  67  67  67  67  67  67  67  67  67  67  67  67  
67  67  67  67  67  67  67  67  31  32  33 
31  32  33  37  37  37  37  37  4  4  4  4  4  4  4  4  
4  4  4  4  4  37  37  37  37  4  4  4  4  4  4  4  
4  4  4  4  4  4  4  37  37  37  37  4  4  4  4  4  
4  4  4  4  4  4  4  37  37  37  37  4  4  4  4  37  
37  37  37  37  37  37  37  37  31  32  33 
19  20  21  43  43  43  43  43  7  8  9  7  8  9  7  8  
9  7  7  8  9  37  37  37  37  7  8  9  7  8  9  7  
8  9  7  7  7  8  9  37  37  37  37  7  8  9  7  8  
9  7  8  9  7  8  9  37  37  37  37  7  7  8  9  43  
43  43  43  43  43  43  43  43  31  32  33 
19  20  21  49  49  49  49  49  13  14  15  13  14  15  13  14  
15  13  13  14  15  37  37  37  37  13  14  15  13  14  15  13  
14  15  13  13  13  14  15  37  37  37  37  13  14  15  13  14  
15  13  14  15  13  14  15  37  37  37  37  13  13  14  15  49  
49  49  49  49  49  49  49  49  31  32  33 
19  20  21  55  55  55  55  55  55  55  55  55  55  55  55  55  
55  55  55  55  55  55  55  55  55  55  55  55  55  55  55  55  
55  55  55  55  55  55  55  55  55  55  55  55  55  55  55  55  
55  55  55  55  55  55  55  55  55  55  55  55  55  55  55  55  
55  55  55  55  55  55  55  55  31  32  33 
19  20  21  61  61  61  61  61  61  61  61  61  61  61  61  61  
61  61  61  61  61  61  61  61  61  61  61  61  61  61  61  61  
61  61  61  61  61  61  61  61  61  61  61  61  61  61  61  61  
61  61  61  61  61  61  61  61  61  61  61  61  61  61  61  61  
61  61  61  61  61  61  61  61  31  32  33 
25  26  27  67  67  67  67  37  37  37  37  37  37  37  37  37  
37  37  37  37  37  37  37  37  37  37  37  37  37  37  38  39  
40  41  42  67  67  67  67  67  67  67  67  67  67  67  67  67  
67  67  67  67  67  67  67  67  67  67  67  37  67  67  67  67  
67  67  67  67  67  67  67  67  31  31  32 
31  32  33  37  37  37  37  37  37  37  37  37  37  37  37  37  
37  37  37  37  37  4  4  4  4  37  37  37  37  37  37  37  
37  37  37  37  37  37  37  4  4  4  4  37  37  37  37  37  
37  37  37  37  37  37  37  4  4  4  4  37  37  37  37  37  
37  37  37  37  37  37  37  37  31  32  33 
19  20  21  43  43  43  43  43  43  43  43  43  43  43  43  43  
43  43  43  43  43  25  25  26  27  43  43  43  43  43  43  43  
43  43  43  43  43  43  43  25  25  26  27  43  43  43  43  43  
43  43  43  43  43  43  43  25  26  27  25  37  37  43  43  43  
43  43  43  43  43  43  43  43  31  32  33 
19  20  21  49  49  49  49  49  49  49  49  49  49  49  49  49  
49  49  49  49  49  31  31  32  33  49  49  49  49  49  49  49  
49  49  49  49  49  49  49  20  31  32  33  49  49  49  49  49  
49  49  49  49  49  49  49  31  32  33  31  37  37  49  49  49  
49  49  49  49  49  49  49  49  31  32  33 
25  26  27  4  4  4  4  4  4  4  4  4  4  4  4  4  
4  4  4  4  4  20  20  20  20  4  4  4  4  4  4  4  
4  4  4  4  4  4  4  20  20  20  20  4  4  4  4  4  
4  4  4  4  4  4  4  20  20  20  20  4  4  4  4  4  
4  4  4  4  4  4  5  6  31  32  33 
31  32  33  10  10  10  10  10  10  10  10  10  10  10  10  10  
10  10  10  10  10  10  10  10  10  10  10  10  10  10  10  10  
10  10  10  10  10  10  10  20  10  10  10  10  10  10  10  10  
10  10  10  10  10  10  10  10  10  10  10  10  10  10  10  10  
10  10  10  10  10  10  11  12  31  32  33 
19  20  21  16  16  16  16  16  16  16  16  16  16  16  16  16  
16  16  16  16  16  16  16  16  16  16  16  16  16  16  16  16  
16  16  16  16  16  16  16  16  16  16  16  16  16  16  16  16  
16  16  16  16  16  16  16  16  16  16  16  16  16  16  16  16  
16  16  16  16  16  16  17  18  31  31  31


1 2 3 4 5 6 7 8 9 10 11 12 13 14 15 16 17 18 19 20 21 22 23 24 25 26 27 28 29 30 31 32 33 34 35 36